############
#1 2      .#
## $   ### #
 #£ #  #  ##
 # ## $ : # 
## # :    #
#.      # # 
#     : # ##
##   ####£ #
 # £       #
 #    $   .#
 ###########