      ####
####### 1#
#        #
#    ##  #
## #   # #
 # $  .  #
 # #   # ##
 #   # #  #
 #        #
 #2 #######
 ####
