   ########
   #      #
   #    $ #
####  £   #
#2$  ##  ##
#:   :   .#
#  ##  1  #
###    ####
  # £  #
  #   .#
  ######