
  #######
  #  2   #
###   $  #
#        ##
#  £     ##
##       #
##     £  #
#:  $   1 ##
#.      .:##
###########