###########
#    ##  ##
#    ## £##
#         ##
#2   ##   ##
#.   ## 1 ##
#:  $##   ##
#.   ## £ ##
#:  £##   ##
#: $ ## $ ##
#.   ##   ##
############