    ####  
  ###  #
  # 2  ###
  #1$    #
  #£$### #
  #:.:..:#
###$£## ##
#   £    #
#   ##   #
##########