############
# .     :# #
#   ###    #
#    #  .$ #
#   $ £    #
#  #    £ ##
#  # 12    #
#    ####  #
# :$ ####: #
##  £   .  #
#     #### #
############