     ######
 #####:   #
 #  #..## #
 #  $::   #
 # $# .# ##
### ##£#  #
# £    £$ #
# # #  #  #
#12 #######
#####