      ####
####### 1#
#        #
#   $##  #
## # .:# #
 # £ :.  #
 # #   # ##
 #   # #£ #
 #   $    #
 #2 #######
 ####
