  ########
  #     1#
  #$     #
  #      #
###     ##
#  £  £ ##
#2$      #
#        #
### :.   #
  #   .: #
  ########