  #########
  #    :  #
  #  $   1#
###   #   #
#   £ :   #
#  #    # #
#   . $.# #
#2     £  #
#####     #
    #     #
    #######