############
# .     :# #
#    ##£   #
#       .$ #
####  £#####
#####   ####
#  # 12  : #
# £   ###$ #
# :$ ####  #
##      .  #
#     #### #
############